WWWW-O-WWW
---W------
--WWWWWW-W
----------
WWWWWWWWW-
----------
-WW-WW-WW-
----------
WW-WW-WW-W
X---------